
                    SO textures/testing/south_testing.xpm
NO                                     textures/testing/north_testing.xpm
WE textures/testing/west_testing.xpm                                
EA textures/testing/east_testing.xpm
    F          38  ,38 ,        38
C       102, 141 , 188     




   
        111111111111111111111111
        1000000000110000000000001
        1011000001110000000000001
        10010000000000000000000W1
 1111111011000001110000000000001
1000000000110000011101111111111
11110111111111011100000010001
11100111111111011101010010001
11001000110101011100000010001
1001 100000000001100000010001
10001000000000001101010010001
11000001110101011111011110001111
11110111 1110101 101111010001
 1111111 111111   11111111111


