W textures/testing/west_testing.xpm
C textures/matrix.xpm
F textures/gengar/map/floor.xpm
E textures/gengar/map/exit.xpm
D2 textures/gengar/map/door/door2.xpm
D4 textures/gengar/map/door/door4.xpm
D3 textures/gengar/map/door/door3.xpm
D6 textures/gengar/map/door/door6.xpm
D5 textures/gengar/map/door/door5.xpm
D7 textures/gengar/map/door/door7.xpm
D1 textures/gengar/map/door/door1.xpm

        111111111111111111111111
        1000000000110000000000001
        1011000001110000000000001
        1001000000000000000000001
 1111111011000001110000000000001
1000000000110000011101111111111
11110111111111011100000010001
11100111111111011101010010001
11001000110101011100000010001
1001 10000000000110000N010001
10001000000000001101010010001
11000001110101011111011110001111
11110111 1110101 101111010001
 1111111 111111   11111111111


