W textures/gengar/map/wall.xpm
W2 textures/gengar/map/window.xpm
C textures/gengar/map/ceil.xpm
E textures/gengar/map/exit.xpm
F textures/gengar/map/floor.xpm
D2 textures/gengar/map/door/door2.xpm
D4 textures/gengar/map/door/door4.xpm
D3 textures/gengar/map/door/door3.xpm
D6 textures/gengar/map/door/door6.xpm
D5 textures/gengar/map/door/door5.xpm
D7 textures/gengar/map/door/door7.xpm
D1 textures/gengar/map/door/door1.xpm

111211121112111211121112111
2E0000000011000000000000002
101110111111011110111110001
200000100000010000100010102
1111D1101110111110101010001
2000000000D0000000101000002
101111011110111110111D11111
200000010000100000000000002
101111111D11101111011110001
200010000000100010000010002
111D1111111110111111D111101
200000000000000000010000002
1D11110111101111101111D1101
200010010000100000000000002
111110111011101111111111101
200000000000100000000000002
111211121112111211121112111



