W textures/gengar/map/wall.xpm
W2 textures/gengar/map/window.xpm
C textures/gengar/map/ceil.xpm
F textures/gengar/map/floor.xpm
E textures/gengar/map/exit.xpm
D2 textures/gengar/map/door/door2.xpm
D4 textures/gengar/map/door/door4.xpm
D3 textures/gengar/map/door/door3.xpm
D6 textures/gengar/map/door/door6.xpm
D5 textures/gengar/map/door/door5.xpm
D7 textures/gengar/map/door/door7.xpm
D1 textures/gengar/map/door/door1.xpm

1221
1001
1001
1001
1001
1N01
1111
